XXXXXXXXXXXXXXXXXXXXXXX
X                     X
X          f          X
X                     X
X          c          X
X                     X
X                     X
X                     X
X                     X
X                     X
X                     X
X            A        X
X        b            X
X                     X
X                     X
X                     X
X                     X
X                     X
X                  a  X
X                     X
X                     X
X                     X
XXXXXXXXXXXXXXXXXXXXXXX