   x   x   x   
 d           c 
   x   x   x   
x xxx xxx xxx x
   xf  x   x   
   x   x m x   
   x   x   x   
x xxxxxxxxxxx x
   x   x   x   
 a           b 
   x   x   x   